11 11
0W0W0W0W0W0
LWLWLWLWLWL
AWBWCWDWEW0
00000000000
00L0000L0La
0000000000b
L000000000c
0W00L0000Ld
0W00000000e
LW0000L0000
SW000000000
