8 8
000W00L0
LW0W0000
000W0WWW
000W0000
G00WWWAW
L00L0000
00WWWWWW
SL000000
