8 8
000W000G
0W0W0000
0A0W0WWW
0BaW0000
0C0WWWAW
0D000000
0EWWWWWW
S00abcde
