11 11
0W0W0W0W0W0
LWLWLWLWLWL
AWBWCWDWEW0
00000000000
00L0000L000
00000000000
L0000000000
0W00L0000L0
0W000000000
LW0000L0000
SW000000000
