11 11
bWcWdWeWLW0
LWLWLWLWGWL
AWBWCWDWEW0
00000L00000
00L000000La
00000000000
L000000000L
0W00L0000L0
0W000000000
LW0000L0000
SW00000000L
